###################################################################################################################################################################################
#.#.........#.#.....#.#.#.#.#.........#...#.......#.....#.#.....#...#.......#.#...#.#.....#...#.....#.................#.#...#.....#.....#.....#.............#.........#.#.....#0#.#
#.###.#.#.#.#.#.#.#.#.#.#.#.#####.#.#.#.#.#.###.#.#.###.#.#.#.#.#.###.#.#.#.#.#.#.#.#.#.#.#.#.#.#.###.#.#.#.#.###.#.#.#.#.#.#.#.###.#.#.#.#.#####.#####.#.#.#.#.#.#.#.#.###.#.#.#.#
#.......#.......#.#...#.....#...#.#...#...#.....#2#.#...#.#.....#...#...#.......#...#...#.....#.#.#.....#...#.#.....#.........#.#.#.....#.......#...#.....#.......#.....#...#...#.#
#.###.#.#.#.###.#####.#.#.#.###.#.###.#.#.###.#.#####.#.#####.#.#.#.#########.#.#.#######.###.#.#.#.#.#.###.#.#.#.#.###.#.#.#.#.#.#.#.###.###.#.#.###.#####.#.#.#####.#.###.#.#.#.#
#.....#...........#...#.......................#...........#.#...#.#.#.#.....#.#...#...#.#...#.#.........#...#.....#...#...#.....#.....#.....#...#.....#.#...#...........#.....#.#.#
#####.###.#########.###.#.#########.###.###.#.#####.#####.#.#.#####.#.#.#.###.#.#.#.#.#.###.#.###########.#.#.#.#.#.#####.#######.###.#.###.#.###.#####.#.#.#####.#.#.###.###.#.#.#
#...#.#1..#...........#.#.....#...#.#.....#...#...#...........#...#.......#...............#...#.......#.....#.....#.#...#.....#...#.#.#.......#.......#.............#...........#.#
#.#.#.#.###.#.#.#.#.###.#.#.#.#.#.#.#.###.#.#.#.#.#.#.#.#####.#####.###.#.#.#######.#####.###.#.###.#.#.###.#.#.###.#.#.#.#.#.#.###.#.#.###.#.#.#.#.#.#.#.#.#.###.#######.#.#######
#...#...#...#.....#...#...........#...#.#...#...#.#.#.#...#...#...#...#.#...#.#.......#...#...#.#.....#.#.....#.....#.....#.....#.#.#...#...#.#.....#.....#.....#.......#.#.#.....#
#.#.#.#.###.#.#####.#.#.#.#.#####.#.#.#.#.###.#.#.#.#.#####.#.#.#.#.#.#.###.#.#.#.#.#.#####.#.#.#.#.###.###.#.###.###.###.#.#.#.#.#.###.###.#.###.#.#.###.#.###.#.#.###.#.###.#.###
#...#...#...#...........#.........#.#.#.#.....#.#.#.#.#.........#.....#.#.......#.#.#...#.....#...#...#.......#.#.....#.#.....#.......#...#.#.#...#.#.#...#.#...#.#...#.#.#...#.#.#
#.###.###.#.#.#.#.#.###.#.#.#.#.#.#.#.#.###.#.#####.#.#.#.#.#####.#.#.#.#.#.###.#.#.###.###.###.#######.#.#####.###.#.#.#.###.#.#.###.#.#.#.#.#.#.#.###.#.###.#.#.#.#####.#.#.#.#.#
#...#.#...#.#.#.............#.......#.#...............#.#.#.....#...#.#...#.....#...#...................#.....#.#.#.....#.........#...#.#...#.......#...#...#...#.#.......#.....#.#
###.#.#.#.#.#.#######.#.#.#.#.#.###.#####.###.#.#.###.#.###.###.#.#.#.#.#.#.#########.###.#.#.###.#.#.#.#.#.#.#.#.#.###.###########.#.#.#####.#.#####.#.#.#.###.#.#.###.#.###.#.#.#
#...#.....#...#...#...#.#...#.....#.#.......#.....#...#...#.#.....#...#...#...#.......#.............#.....#...#.....#.......#.....#.#.#.......#.....#...#.....#...#.....#.#...#...#
#.#.#####.#########.#.#.#.#.###########.###.###.#.#.#.#.#.#.#####.#.###.#.#.###.#####.#.#.#####.###.#.#.###.#.#.###.#.###.#.#.#.###.#.#.#.#####.#.#.#.#.#.#.#.#.#.#.#####.#.#.#.###
#.........#.#...........#.#.#...#.#.....#.....#...........#.#.....#.....#...#.#...#.#.......#...#.#.......#.....#...#...#...#.......#.#.......#.#.....#...#...#.#.#.#4........#...#
#.###.#.###.#.#.#.#.#.#.#.#.#.#.#.#.#.#.#.#.#############.#.#.#######.#.#.#.#.###.#.#.#####.#.#.#.#.#.#.#.#.#.#.#.#.#.#.#.#.#.###.###.#.#.###.#.#.#.#.#.#.#.#.#.#.#.###.#.#####.#.#
#3........#...#...#.#.#.#...#...#.....#...#.#...#...#.#.#.#...#.....#.#.#.#.............#.........#.#.....#.....#.#.............#.#.#.#...#...#...#.#.............#.#...#.....#...#
###.###.#.#.###.###.###.#.#####.#####.#####.#.#.#.#.#.#.###.#.#.#.#.#.#####.###.###.#.###.#.#.#.#.#.#.#.###.#.###.###########.###.#.#.#.#.#.#.#.#####.###.#.#.#.#.#.###.###.#.#.#.#
#...#.......#.#.#...............#.........#...#.....#.#...........#.#.........#.....#.........#...#...#.........#.......#.......#.........#.....#.#...#...#.#.#.....#.............#
#.#.###.#####.###.###.#.###.#.###.#.#.###.###.#.#####.#######.###.#.#.###.#####.#.#.#.#.#.#.###.#.#####.#.#.#######.#.#.###.###.#.#.###.#.###.#.#.###.#############.#.###.#.#####.#
#.#.#...#...#.#...#.#...#...#.....#.#.........#.......#.............#.#...#.........#.#.....#.....#.....#...#.....#...#...#.....#...#...#.........#...#.....#.........#...#.....#.#
#.#####.#.#.#.#.#.#.#.#.#.#.#.#####.#.#.#.#.###.#.###.#.#.###.###.#.###.#.#.#.#.###.#.#####.###.#.###.#########.#.#.#####.#.#.#.#.#.###.###.###.#.#.#.#.###.#.#.#.#.###.#.#.#.#.#.#
#.................#...#...#.#...........#.#.#.......#.......#...#.#...#...#.#...#.#.#.......#.#.#...#...........#.............#.#...#...#.......#...#.#.....#...#.#...#...#.......#
#.#.#.#.#.###.###.#.#.#####.#.#.#.#####.#.#.#.###.#.#######.###.#.#.###.#.#.#####.#.#####.#.#.#.#.#.#.#.#.#.#.#.#.###.#.#####.#####.###.#.#.###.#.#.#.#.#.#.#.###.#.#.#.#.#####.#.#
#...#.#.#...#.....#.#.#.......#...#...#...#.......................#.#.....#.................#.....#.......#...#...........#...#...........#...#...#...#.....#.#.#...#.#.#...#...#.#
#.#.#.#.###.#.#######.#####.###.#.#.#.###.#.###.#.#.###.#.#.#.###.#####.#.#.#.#.#.###.#.#####.###.#######.#.#.#.###.###.#.###.#.#.###.###.#.#.###.###.#.###.###.###.#.#.###.#.#.#.#
#...#...#.#.#...#...#.#...#...#.#.....#.#...#.....#.....#.....#.#.....#.....#.#...#.#...#.........#.....#.#.....................#...#...#.#...#...#...#.#.....#.#...#.....#...#...#
#.#####.#.#####.###.#.#.#.#.#.#.#.#.###.#####.#.#.#.###.#.###.#.###.#.###.###.#.#.#.###.#.#.#.#.#.#.#.#.#.#.###.#.###.#.#######.#.#.#.#.#.#.#.#.#.#.#.#.#.#####.#.#.#.#.#.#.#.#.#.#
#.....#.#.#7..#.#.......#...#.#.....#...#.........#...#.#...#.......#.....#...#.#...#.#...#.#.#.#.#.......#.....#...#...#.........#.....#...#.....#.....#.#.....#.............#..5#
#.###.#.#.###.#.###.#######.#.#####.###.#.#.###.#.#.#.#.###.###.#.#.#####.#.#.#.#.#.#.#.###.#.#.#.#.#.###.###.###.#.#####.###.#.###.#.#.#.#.#.#####.#.#.#.#.#####.#.#.#.#.###.#.#.#
#.......#.....#.....#.#.......#.#.#...#...#6#.#.......#...#.#.#.....#.#.#.....#.....#.....#.....#.#...#.........#...#...#.#.......#.#.#...#.#...#...#.....#.#.....#...#...#...#.#.#
###.#.###.#.#.#.#.#.#.#.###.#.#.#.#.###.#.#.#.#####.#.#####.#.#.#.#.#.#.###.#.#####.#.#.#.#######.#.#.#####.#.#.#.#.#.#.#.###.###.###.#.#.#.#.#######.#.#.#.#.#.#.#.#.###.#.#.#.#.#
#...#.#...#.#.....#...#.....#...#.#.....#...#.#...#.#.......#...#.....#...#.......#.....#.#...#...#...#.#...#.....#.....#.........#.#.......#.#.......#.#.....#.....#.#...........#
#.#.#.###.#.###.###.#.#.#.#.#.#.#.#.#.#.#.#.#.#.#######.###.#.#.#####.###.#.#.#.#.#.#.#.#.###.#.#.#####.###.###.###.#.#.#.#.#.#####.#.#####.#.#.#.###.#.###.#.#.#####.#.#.#######.#
#.#.#...#.......#.....#...#.#...#...................#...#...#...#...#.......#.#.....#...#...#.........#.....#...........#...#.#.#.#.#.#...#.........#.#.........#.#...#.....#.#...#
###################################################################################################################################################################################